....:.:....:.....:
.:.....:..:...::..
..::........:.....
.....:..::........
:.................
.............:....
E...............:.
