.....:.........
...........::..
.:..:....:.....
.......:.......
...............
.............::
......:........
...:...........
:.:............
E.......:.:....
