XXXXXXXXX
X.......X
X.XXXXXXX
X.......X
X.XXXXXXX
X.......X
X.XXXXXXX
X.......X
X.XXXXXXX
XN......X
XXXXXXXXX
