...........................
...........................
..:.:.:...:.:.:.:.:.:.:.:..
...........................
..:...:.:...............:..
...........................
..:.:...:.......:.:.:.:.:..
...........................
....:...:.:...:.:..........
...........................
....:.W...:.:.:............
...........................
...........................
