.................................................................
.................................................................
..:.:.:.:.:.:.....:.:.:.:.:.:.:...:.:.:...:.:.:...:.:.:.:.:.:.:..
.................................................................
..:.........:.....:...........:...:...:...:...:...:...........:..
.................................................................
..:.........:.:...:...........:...:...:...:...:...:...:.:.:.:.:..
.................................................................
..:...........:...:...........:...:...:...:...:...:...:..........
.................................................................
..:...........:...:...:.:.:.:.:...:...:...:...:...:...:.:.:.:.:..
.................................................................
..:...........:...:...:...........:...:...:...:...:...........:..
.................................................................
..:...........:...:...:.:.:.:.:...:...:...:...:...:...:.:.:.:.:..
.................................................................
..:...........:...:...........:...:...:...:...:...:...:..........
.................................................................
..:.........:.:...:...........:...:...:.:.:...:...:...:.:.:.:.:..
.................................................................
..:.........:.....:...........:...:...........:...:...........:..
.................................................................
..:.:.:.W...:.:.:.:...........:.:.:...........:.:.:...:.:.:.:.:..
.................................................................
.................................................................
