XXXXXXXXX
XE......X
X:......X
X::.....X
X:::....X
X::::...X
X:::::..X
X::::::.X
X:::::::X
XXXXXXXXX