XXXXXXXXX
X.:::::WX
X:XXXXX:X
X:XXXXX:X
X:XXXXX:X
X:XXXXX:X
X:XXXXX:X
X.:::::.X
XXXXXXXXX
