E...........
.......:....
.......::...
.......::...
.......::...
.......::...
.......::...
.:....:::...
.:....:::...
.:....:::..:
.:..:.:::..:
.:..:.:::.::
::..:.:::.::
::..:::::.::
::..:::::.::
:::::::::.::
::::::::::::
